22	10
......................
..#########...........
..#.......#...........
..#.......#...........
..#.......#...........
..#.......#...........
..###.....#######.....
..#.............#.....
..#.............#.....
..###############.....